as she sat with the terracotta jar		between her knees and spelt out the sign
the old lady smiled and shook her head		you could n't afford her remarked adam good-humouredly
in a nasty perverted way it was exciting		a woman-in-me reaching to a man-in-him
thacker lifted his eyebrows in puzzlement		i want to whisper in your shell-like ear
and where are we all supposed to sleep		the three of us all together in one bed
i was elated excited in another world		it was everything i had ever wanted
the blocking of natural functions can damage our health		there are alternatives which relieve our immediate tension
ace stared morosely down at the rocks		another unlikely stroke of luck she said
do n't talk to me like that		well do n't shout at me
fear of the phenomenon is also present		what do i say to this woman
at any rate this identification is now confirmed		& this helianor was of the daughters heirs
the blade sliced into the thick material		tolby flinched as it touched the skin
but i was saying any way i like		er i ca n't do it any more
now most is used in the making of paper		it gives the paper its smooth glossy surface
an eighth admitted assisting an offender		charges against another man were withdrawn
yeah definitely poorly mother 's sick for a fortnight		well off we go back to work
i 'm going to ask the police now		would you like to come with me mrs harland
in future this should not be the case		london bids to boost global emergency plan
one had the appearance of a briefcase		the other fitted with drawers was always kept upright
your life is an illness you old witch		well it 's up to you mum
when will you go asked rachaela		ruth must be listening behind the screen
one is from scotland the other from england		the strone and maukinhill informal education project
but marriage he paused marriage is a serious proposition		for you perhaps even more than for me
hundred and eight hundred and nine		well that 's alright we 're hundred and ten
i 've got the nine have i		yes i have game in n it
madame al√®gre would make an impression on anyone		did you ever tell anybody else about this
arrests are increasing and sentences are harsh		but what are the legal alternatives
any number squared gives you a positive number		a look of glee swept across bob 's face
erm i parked on the top		so it was n't all dark and that
they cut fences and drive across crops		these men are accustomed to physical violence and intimidation
you 'll be wanting a nice engraved invitation next		bring your dj with you did you
on the back of his slim hands		holding mine at the edge of our lands
why do i get into trouble like this		perhaps i wo n't make any mistakes tomorrow
what those buildings actually were is still doubtful		certainly they are not very domestic
the inboard computer flashed stats at him		the weapons systems gave him some readiness read-outs
do n't i know it she said quickly		i tell yer what though nell
oh dear acropolis park looks suspiciously dark		you do n't fool me crevecoeur
they were were n't hemmed or anything		well i said that 's understandable she said well
take it on that one over there		peter she asked as she went over to it
but what if it never did		leonora fought down a sudden rush of panic
i do n't wan na go		well unfortunately it 's not what you want
my god did the lift go down low enough		i did it for the girl he protested
either you 've got it or you have n't		suitability for the profession is deep-rooted and genetic
i agreed to stay until the morning		hell i did n't actually agree to anything
where do you want to eat this		here or in the other room
i will not violate the sanctity of that union		you must marry me whatever it costs
it is a change some make in private		only the larvae of insects have silk glands
best bitch and best of opposite sex was ch.		poirot vanessa owned by peter phillips and conrodd chen
i know where i 'm gon na put it		where are you gon na put it
it was the mp christopher court		now what 's he doing here
they 're our biggest competitor virginia pointed out unnecessarily		she won a gleam of mocking agreement from guy
she very obviously wanted to be left alone		but after a few days clare began to worry
that 's all from us for now		our next bulletin will be at 10.35 p.m
no he probably means the twentieth		i 'm just going in here
there 's no need to rub it in		you do n't know how difficult it is
you know and it 's got		that was in mint condition was n't it
daly was unavailable for comment yesterday		bush now the target after iran trial fury
still to come on central news		six of the best from swindon
refurbished premises at 5/7 stanhope street liverpool		if you need a refreshing sleep
she flung the choking clawing creature from her		she flung him into the grand canal
or rather they 've set out to meet me		i even imagined myself in love once
striped shirt and pink tie perked up a little		they asked for particulars pink tie made some notes
the soviets had demonstrated unsuspected scientific and engineering skills		no comparable american rocket had yet been successfully tested
why are you at the wheel		complaints he drawled without turning around nothing but complaints
several lines of action became clear		he and we are following them
5 3 run to you rage		6 13 be my baby v paradis
howard 's right darling murmurs caroline		you must n't keep running yourself down
the swords are going in the bin		i did n't realise this programme was still running
but even if it were in would be ineffective		the the the intelligence is insufficient
one and one and a bit gangs		that seems to that looks sensible it seems to
it allows responsiveness to the customer or the client		it will break down bureaucratic procedures
you wo n't be able to go in		well it 's not good unless go back
as though not one of us had realised		the world could go on glistening
when you go up and down stairs and		i noticed a bit more lately yeah
can i keep another plec with the existing one		should i keep my cardinals in this tank
my job and my life on it		the flat unemotional voice carried complete conviction
do n't trust him i beg you		he 's as good as anybody in the village
he paused still looking at her		how like mary she was incredible
there are a number of alternative routes to specialization		a tailor-made curriculum for each discipline or specialization
this rule is being rigorously enforced this year		work outside these limits must be removed
andrews snipped and sewed the masterpiece into one-piece garments		who knows a fashion trend might be created
that sounds great coming from a p-r-o-g-r-a-m-m-e-d computer		she strapped herself into her seat
of course you will live why when the summer		wilson i saw your look just now dear
it is a very nice day		mm going to be a nice day
she turned scarlet and said explosively you silly goof		do you think i 'm trying to back out
we 're a very close family		harm one of us and you harm the others
but i 've never seen a child there		sam chewed on his bit of cheese and deliberated
catherine gave a gurgle of laughter		oh james you are a clown
katherine 's heart skipped a beat		she charged off in search of her mother
if you do n't want to fly		what do you want to do
oh i did n't notice all that lot		i was looking at this one with the
we 're not talking sub-clause seventy-nine sunshine		we 're talking about rescinding the entire brief
it 's ruth 's birthday today		it is ruth 's birthday today
go to a live sex show 22%		read a hard porn magazine 21%
he coughed a great wracking of torn tissue		more blood appeared in the corner of his mouth
he was starting to confuse her		then he smiled lop-sidedly and confused her even further
i have never known so many articles on russian		it might be a thing in there
hampden refused to buy a knighthood from the king		his descendant today is earl of buckinghamshire
i do n't enjoy talking about susan much		i 'm still in love with her
er let me see what i 've got here		i thought you 'd go you deserted us
causalism rather gives a topic-neutral conception of consciousness		causalism can be considered together with something else
i had no choice because i was starving		i felt sick after that he said
lucky we got over then said dorcas		there 's some dangerous drivers around
you and pearce were in charge that night		and i telephoned your lot when it happened
and she was n't his girl		more show of his contempt for her
but that does n't solve the immediate problem		those surfaces you dismiss so readily have hard edges
please come prepared for a short wait		the bristol cancer help centre study
was that a soft landing you had back there		no i got a very sore
findings firmly established form the basis of discussion		neglect our advice at your peril
i think she did as well		and there was her attitude towards the baby
brown in the autumn grass is blown		and brittle rustling dry children 's hair
but stayed at home by the fireside		watching dreams burn there one by one
yes forty five years of age		we packed her off the the following day
next to the cabinet office is the scottish office		then the back of the horse guards
we can drive off alone and see the sights		her pulses leapt with a ferocity that alarmed her
what does freud say about sadism and masochism		i tried to clear my sleepy brain
i hope i did n't inconvenience you		you did as a matter of fact
a whippet jack-knifes across the grass		to where the afghan 's palomino fringe
oh that thing that was supposed		it was crap was n't it
today 's figures will do little to dispel it		back to nature 's drawing board
does your knitting machine have psychic powers		is it tuned in to your every mood
about her nagging spying you can guess		i 'm not bothered about it myself
shuttling from the coal shed to my room		and dream like caliban of getting free
there is n't an enormous difference let's face it		it 's grounded in something more now
our astropath will accompany us jaq said		if he could but consult his tarot
what level of training they need		okay so that 's the level of training
do you know where he is		ipuky took his drink and sipped it
the shares were ¬Ω lower at 10¬Ωp		city boosey plays a high note
whereupon clements struck his narrow forehead		oh god do n't say i was married
the papacy encapsulates the meaning of history		this used to be a perception shared with protestants
blink and the splash of sunlight		is in fact a hidden bud of primrose
is the building structurally sound and weatherproof		how much will have to be spent on it
6 sarcophagus of lucius cornelius scipio barbatus		made in the early 3rd century bc
investment in commodities and property are not permitted		although see the section below on property unit trusts
it would be a good day		just twenty-five men on the range
well did n't you she challenged		as it happened yes he shocked her by saying
winner itn 's inspiring london headquarters		knockout the judges loved stansted airport
roles v nathan 1963 1 wlr 1117		general cleaning contractors v christmas 1953 ac 180
each case is considered on its merits		there are at least two categories
erm going back to bonnie 's house		there 's nowhere to go is there really
he did look up then his tone sharp		what a very nasty suspicious mind you have
she looked up at the statue and laughed		the black brows knit and solid silver laurels bobbed
do n't tell me what they are		in fact do n't tell anyone
buffet-style restaurant with √† la carte section		tv room shops/boutiques hairdresser open-air stage
we discuss having fun at university		i think it 's so important to have fun
but she was wailing among her friends		ranald spoke up an arm round luch 's shoulders
will i be working here tomorrow		3.05 they 're on the bus
marshall valvestate 100 watt cash waiting		mesa boogie mkiii in hardwood with flightcase
wpc gill dodd milton keynes police		pc paul woodham milton keynes police
he was taking a dish out of the refrigerator		sha n't see her for hours
one your lucy is a stunner		can you pick'em girl or can you pick'em
that 's where i was staying		as well tha we went there did n't we
each of these propositions will be examined separately		i parliament the supreme law-making authority
meredith grinned at the outrageous exaggeration		my that 's a long time she chuckled
he bets with me now and then nothing special		tell me why are you here
what were you offering as an inducement		i do n't understand what you mean
she managed to get down the ladder		and then she collapsed in one of the bedrooms
that 's set my ears ringing		has it done the same to you
why did n't you send for me at once		we are quite all right said rose smiling
stephens v. cuckfield rural district council 1960 2 q.b		373 1960 3 w.l.r. 248 1960 2 all e.r.
she shivered at the promise explicit in his voice		a promise that was abundantly kept
the regulation will come into force early in 1995		scotland cabinet minister is guest of scottish branch
thank you mark said with sincerity		and i 've enjoyed working with you too
they left the cafe and hailed a passing cab		they failed to notice ralph grunte
his face a black skull with a slaty shine		who slipped his body with one fluid motion
and that 's one thing that		right well i never have either
no i was in all the evening		do you know about your sister
peter a. gledhill 15 katherine street darlington		last friday jacqueline fletcher was freed from prison
details june dyer or nicky gibbard		safety is the name of the game
of snow nor feel its sudden flight		alarm our sleeping eyes and play
the headache seemed to split her skull		you husband telephoned she heard the doctor say
i i 'll i 'll buy that		what 's this one we 're bidding on
go and leave me in my bed		with her photo in your wallet
do you want me to follow her there		are you familiar with the city
she 'd rather admired the man		he 'd been patronised and shown no resentment
where is this apartment you share with your lover		ruth snatched her hand away from his
echoed his cry it is finished		now with new life we can be blessed
drawing on pincoffs 1975 he argues that		educational goals consist in the development of excellences
alastair mciver reports from queen 's club		they do n't play cricket in sweden
what data transmission speeds are proposed		which of the following options is available
it was two in the morning		she had been downstairs to make tea
typically these questions will include the following		what products can you remember seeing ads for
i 've arranged for you to take miss p.		i do n't want to watch polo
you can afford to have that baby		what and the baby 'll get everything
ah well i said with a light laugh		i 'm sure i can explain
why anything could happen in her nightmare		she might have left a cigarette lit
do n't miss out on the fun		join our clothes show club today
i did n't want to understand		i knew granny 's speech was an awful speech
a cherry lipstick in her forced cleavage		then lower her mouth gingerly onto it
spruce 's immediate response was inaudible		any idea of when he asked finally
i have done it so badly		nathan has said not to say his name
what extracurricular activities was i involved with at school		what does this show about my interests
she smiled happily her delight genuine		life had taken a turn for the better
we could have a trial run oh paul 's		then we 'll all have the school dinners
but it was worse than that		he was waiting for him to get up
tell her again cos she were n't listening		look i 've got a tooth missing
write home about i 'm the best		thing in your life but i 'm best
source beathing the ban hea 1990		a voluntary agreement is more flexible and effective
it will keep its regional and national leadership intact		local recruiting offices are already open
lyons keep the flavour * lyons keep the taste		hypo-allergenic treatment make-up to care for your skin
